#####Y#####################################################################
#.........................................................................#
Z@........................................................................Y
#.........................................................................#
###########################################################################
#.........................................................................#
#.........................................................................#
#.........................................................................#
#.........................................................................#
#.........................................................................#
#.........................................................................#
#.........................................................................#
#.........................................................................#
#.........................................................................#
#.........................................................................#
#.........................................................................#
###########################################################################