###########################################################################
#.........................................................................#
Y..@......................................................................#
#.........................................................................#
#.........................................................................#
#.........................................................................#
#.........................................................................#
#.........................................................................#
#.........................................................................#
#.........................................................................#
#.........................................................................#
#.........................................................................#
#.........................................................................#
#.........................................................................#
#.........................................................................#
#.........................................................................#
###########################################################################